111111111
10c010001
1c10c01c1
100110c01
10c1000e1
111111111