11111111111
1C0100C0E11
11000011111
11P0000C111
11111111111