1111111111
1C0100C0E1
1100001111
11P0000C11
1111111111